NSP,Not Found,Total,Remained,Sequence contain X,Not human,Not Match Length
data/nsp1.fasta,31,817,786,17,0,14
data/nsp2.fasta,139,817,678,131,0,8
data/nsp3.fasta,226,817,591,219,0,7
data/nsp4.fasta,117,817,700,117,0,0
data/nsp5.fasta,21,817,796,20,0,1
data/nsp6.fasta,722,817,95,4,0,718
data/nsp7.fasta,3,817,814,3,0,0
data/nsp8.fasta,14,817,803,14,0,0
data/nsp9.fasta,9,817,808,9,0,0
data/nsp10.fasta,21,817,796,19,0,2
data/nsp11.fasta,18,817,799,18,0,0
data/nsp12.fasta,51,817,766,51,0,0
data/nsp13.fasta,100,817,717,99,0,1
data/nsp14.fasta,135,817,682,130,0,5
data/nsp15.fasta,52,817,765,50,0,2
data/nsp16.fasta,112,817,705,112,0,0
data/spike.fasta,749,817,68,33,0,716
data/envelope.fasta,6,817,811,3,0,3
data/membrane.fasta,15,817,802,13,0,2
data/nucleoprotein.fasta,28,817,789,23,0,5
data/orf3a.fasta,61,817,756,34,0,27
data/orf6.fasta,2,817,815,0,0,2
data/orf7a.fasta,189,787,598,27,0,162
data/orf7b.fasta,150,815,665,144,0,6
data/orf8.fasta,721,817,96,5,0,716
data/orf9b.fasta,7,816,809,3,0,4
data/orf9c.fasta,15,816,801,2,0,13
